****************
*S        *   E*
*    *    *    *
*    *    *    *
*    *    *    *
*    *    *    *
*    *         *
****************